00000000000000000000
00000000000000000000
00000000000000000000
00000000000000000000
00111111111111111100
00121000010302100100
00120010010100130100
00131010010100100100
00103010010120030100
00120030000001102100
00111111111111111100
00000000000000000000
00000000000000000000
00000000000000000000
00000000000000000000
00000000000000000000
00000000000000000000
00000000000000000000
00000000000000000000
00000000000000000000					