00000000000000000000
00000000000000000000
00000011111111000000
00000012003001100000
00000010303002100000
00000010121301100000
00000010101002100000
00000010121101100000
00000010111030100000
00000010003002100000
00000011111111100000
00000000000000000000
00000000000000000000
00000000000000000000
00000000000000000000
00000000000000000000
00000000000000000000
00000000000000000000
00000000000000000000
00000000000000000000					